NO                 ./textures/colorstone.xpm
SO   ./textures/greystone.xpm

WE     ./textures/bluestone.xpm
EA   ./textures/wood.xpm

F    255  ,  248  ,  220




C 125   ,255,  26

        1111111111111111111111111
11111111100000000100000000000001
        10110000010S0000000000001
        1001000001000000000000001
111111111011000000000000000000001
100000000011000000000000000111111
11110000001000000000000000001
11110111111110000000000000001
1100001     10011100000000001
10000011111110001100000000001
10000000000000000000000000001
110000011101010111110000000111
11110001 1110101 101000000001
11111111 1111111 111111111111
